11111
1PCE1
10001
10X01
11111
